@@@@@@@@@@@@@@@@@@@@@@@@@@@@@@@@@@@@@@@@@@@@@@@@@@@@@@@@@@@@@@@@@@@@@@@@@@@@@@@@@@@@@@@@@@@@@@@@@@@@@@@@@@@@@@@@@@@@@@@@@@@@
@@@@@@@@@@@@@@@@@@@@@@@@@@@@@@@@@@@@@@@@@@@@@@@@@@@@@@@@@@@@@@@@@@@@@@@@@@@@@@@@@@@@@@@@@@@@@@@@@@@@@@@@@@@@@@@@@@@@@@@@@@@@
@@...................@@...@@...........@@.............@@.................@@........................@@@@@@@@@@@@@@@@@@@@@@@@@
@@...................@@................@@.............@@.................@@........................@@@@@@@@@@@@@@@@@@@@@@@@@
@@........................@@...........@@.............@@.................@@........................@@@@@@@@@@@@@@@@@@@@@@@@@
@@...................@@...@@@@@@@@@@@@@@@.............@@.................@@........................@@@@@@@@@@@@@@@@@@@@@@@@@
@@...................@@...@@@@@@@@@@@@@@@.............@@.................@@........................@@@@@@@@@@@@@@@@@@@@@@@@@
@@@@@@@@@@@@@@@@@@@@@@@...@@...........@@.............@@.................@@........................@@.....................@@
@@@@@@@@@@@@@@@@@@@@@@@................@@.............@@@@@@@@...@@@@@@@@@@@@@@@@@@@@...@@@@@@@@@@@@@.....................@@
@@...................@@...@@...........@@.............@@@@@@@@...@@@@@@@@@@@@@@@@@@@@...@@@@@@@@@@@@@.....................@@
@@...................@@...@@@@@@@@@@@@@@@.............@@...........................................@@.....................@@
@@........................@@@@@@@@@@@@@@@.............@@..................................................................@@
@@...................@@...@@...........@@.............@@..................................................................@@
@@...................@@................@@.............@@..................................................................@@
@@@@@@@@@@@@@@@@@@@@@@@...@@...........@@.............@@...........................................@@.....................@@
@@@@@@@@@@@@@@@@@@@@@@@...@@@@@@@@@@@@@@@@@@@@...@@@@@@@...........................................@@@@@@@@@@@@@@@@@@@@@@@@@
@@...................@@...@@@@@@@@@@@@@@@@@@@@...@@@@@@@...........................................@@@@@@@@@@@@@@@@@@@@@@@@@
@@...................@@...................................................................................................@@
@@........................................................................................................................@@
@@...................@@...................................................................................................@@
@@...................@@............................................................................@@@@@@@@@@@@@@@@@@@@@@@@@
@@@@@@@@@@@@@@@@@@@@@@@............................................................................@@@@@@@@@@@@@@@@@@@@@@@@@
@@@@@@@@@@@@@@@@@@@@@@@...@@.......................................................................@@.....................@@
@@...................@@...@@.......................................................................@@.....................@@
@@...................@@...@@..............................................................................................@@
@@........................@@..............................................................................................@@
@@...................@@...@@.......................................................................@@.....................@@
@@...................@@...@@.......................................................................@@.....................@@
@@@@@@@@@@@@@@@@@@@@@@@@@@@@@@@@@@@@@@@@@@@@@@@@@@@@@@@@@@@@@@@@@@@@@@@@@@@@@@@@@@@@@@@@@@@@@@@@@@@@@@@@@@@@@@@@@@@@@@@@@@@@
@@@@@@@@@@@@@@@@@@@@@@@@@@@@@@@@@@@@@@@@@@@@@@@@@@@@@@@@@@@@@@@@@@@@@@@@@@@@@@@@@@@@@@@@@@@@@@@@@@@@@@@@@@@@@@@@@@@@@@@@@@@@
